##########################
#          ###############
#                    #####
#                    #####
#          ####  #########
#          ####  ##     ##
#          ####  ##     ##
###############  ##     ##
###############  ###   ###
####             ###   ###
####             ###   ###
####  #####      ###   ###
#        ##      ###   ###
#        ##      ###   ###
#        ##      ###   ###
#        ##              #
###########              #
#                        #
#                        #
#                        #
#                        #
#                        #
##########################